###########
#         #
#  #  ### #
#  #    # #
####  ### #
#  ## ##  #
#          
###########